11111111111111111
1P100000000000001
1010111110000C011
1010000E000000001
101111111C0010001
10000000000010001
11111111111111111
