11111111111111111
1P1E1SS000CCCCCC1
101011111CCCCC011
101C0000000000001
101111111C0010001
100000CCCCCC10001
1CCCCCCCCC0CC0001
111110000CC000111
11C00000011111111
11111111111111111
