11111111111111111
1C1E10000000S0001
101011111000C0011
1010000000000C001
10111111100010001
10P00000000010001
1000000000CC0C001
11111000000000011
11000000011111111
11111111111111111
