11111111111111111
1P1E1000000000001
1010111110000C011
10100000000000001
101111111C0010001
10000000000010001
1CCCCCCCCCCCCCCC1
111110000CC000111
11C00000011111111
11111111111111111
