11111111111111111
101000000C0000001
1010000000000C011
10100P00000000001
101000000C0000001
100000000000E0001
11111111111111111
