1111111111
1P00000C01
1000001001
1000100C01
10C0111001
10C00C10E1
1111111111
