1111111
1000E01
1000001
100C0P1
1000001
100C001
1111111
