11111111111111111
1C1E1CCC0000C0001
101111111000C0011
101000000000C0001
10111111100010001
10P00000000010001
1000000C0CCC0C001
111110000CCCCC011
11000000011111111
11111111111111111
