11111111111111111
1ECCCCCCCCCSCCCC1
1CCCCCC1CCCCCCCC1
1CCCCCC1CCCCCCCC1
1CCCCCC1CCCCCSCC1
1CPCCCC1CCCCCCCC1
1CCCCCCC1CCCCCCC1
1CCCCCCCC1CCCCCC1
1CCCCCCCCCCCCCCC1
11111111111111111
