1111111111
1P00000001
1000001001
1000100001
1000111001
10000C10E1
1111111111
