11111111111111111
10C000000C0000C01
100C0000000000111
10000P0000C000B01
100CC00000000E001
11111111111111111
