1111111111
1C1E0000S1
1010110111
1010110111
10P0000001
1111111111
