1111111111
10C00100E1
1011000101
1011111101
10P1100001
1111111111
