111111111
1P0000001
110000011
10E000001
111111111
