111111111
1PCCCCCC1
1CCCCCC11
1CCCCCCE1
111111111